TILEMAP
36 28 							-- Size of tile map in tiles
16 32 							-- Tile size & block size
images/blocks.png 	-- Tilesheet
2 2 								-- Number of tiles in tilesheet
111111111111111111111111111111111111
11                                11
11                                11
11                                11
11                                11
11                                11
11                                11
11                                11
11                                11
11                                11
11                                11
11                                11
11                                11
111111111111111      111111111111111
11                                11
11                                11
11                                11
11                                11
11                                11
11                                11
11                                11
11                                11
11                                11
11                                11
11                                11
11                                11
11                                11
111111111111111111111111111111111111

