TILEMAP
36 60 							-- Size of tile map in tiles
16 32 							-- Tile size & block size tamaño componentes
images/blocks.png 	-- Tilesheet
2 2 								-- Number of tiles in tilesheet
111111111111111111111111111111111111
11                                11
11                                11
11                                11
11                                11
11                                11
11                                11
11                                11
11                                11
11                                11
11                                11
11                                11
11b b b b b b b b b b b b b b b b 11
11g g g g g g g g g g g g g g g g 11
11r r r r r r r r r r r r r r r r 11
11                                11
11                                11
11                                11
11                                11
11                                11
11                                11
11                                11
11                                11
11                                11
11                                11
11                                11
11                                11
111111111111111111111111111111111111
                                    
111111111111111111111111111111111111
11                                11
11                                11
11                                11
11                                11
11                                11
11                                11
11                                11
11                                11
11                                11
11                                11
11                                11
11b b b b b b b b b b b b b b b b 11
11g g g g g g g g g g g g g g g g 11
11r r r r r r r r r r r r r r r r 11
11                                11
11                                11
11                                11
11                                11
11                                11
11                                11
11                                11
11                                11
11                                11
11                                11
11                                11
11                                11
111111111111111111111111111111111111
                                    
                                    
                                    