TILEMAP
24 72							-- Size of tile map in tiles
16 32 							-- Tile size & block size
images/blocks.png 	-- Tilesheet
2 2 								-- Number of tiles in tilesheet
111111111111111111111111
11                    11
11         x          11
11t                   11
11                    11
11                    11
11d c             c d 11
11                    11
11                    11
11                    11
1111111g g g g g 1111111
11                    11
11                    11
11                    11
11                    11
11                    11
11                    11
11                    11
11                    11
11                    11
11                    11
11                    11
11                    11
11111111       111111111
11111111BBBBBBB111111111
11                    11
11                    11
11                    11
11                    11
11                    11
11                    11
11         k          11
11                    11
11r r r b b b b r r r 11
11r r r b b b b r r r 11
11r r r b b b b r r r 11
11                    11
11                    11
11                    11
11                    11
11                    11
11                    11
11                    11
11                    11
11                    11
11                    11
11                    11
11111111       111111111
11111111AAAAAAA111111111
11                    11
11                    11
11                    11
11                    11
11                    11
11                    11
11         ?          11
11                    11
11                    11
11                    11
11                    11
11                    11
11                    11
11                    11
11                    11
11                    11
11                    11
11                    11
11                    11
11                    11
11                    11
11                    11
11111111       111111111
                                                            
                                    
                                    