TILEMAP
24 72							-- Size of tile map in tiles
16 32 							-- Tile size & block size
images/blocks.png 	-- Tilesheet
2 2 								-- Number of tiles in tilesheet
111111111111111111111111
11                  x 11
11  r r r r           11
11  r  t  r           11
11  r     r g g g g   11
11  r r r r g  d  g   11
11          g     g   11
11    ?     g g g g   11
11                    11
11  r r r r           11
11  r  c  r           11
11  r     r           11
11  r r r r           11
11           r r r r  11
11           r  d  r  11
11           r     r  11
11           r r r r  11
11                    11
11                    11
11                    11
11                    11
11                    11
11                    11
11111111       111111111
11111111BBBBBBB111111111
11                    11
11                    11
11                    11
11                    11
11                    11
11                    11
11         k          11
11                    11
11r r r b b b b r r r 11
11g g g b b b b g g g 11
11r r r b b b b r r r 11
11                    11
11                    11
11                    11
11                    11
11                    11
11                    11
11                    11
11                    11
11                    11
11                    11
11                    11
11111111       111111111
11111111AAAAAAA111111111
11                    11
11                    11
11                    11
11                    11
11                    11
11r r r r     r r r r 11
11r b b b     b b b r 11
11r b             b r 11
11r b      k      b r 11
11r b             b r 11
11r b             b r 11
11r b             b r 11
11r b b b     b b b r 11
11r r r r r r r r r r 11
11                    11
11                    11
11                    11
11                    11
11                    11
11                    11
11                    11
11                    11
1111111          1111111
                                                            
                                    
                                    